15x10
VOID:v
GRASS:g
TREE:t
ROCK:r
WATER:w
SPAWN:s

g g g g g g g g g g g v v v v
g g r g g g t w g g g s v v v
g g r g g g g w g g t g g v v
g g g g w w w w g g g g g g v
g g g w w w w w w g g g g g g
r r g g w w w w w g g g t g g
g t g g g w w w w g r r r g g
g g g g g g w w w g g g g g g
g g t t g g g g g w g g g g r
r g g g g g g g g g g g g r r

com.github.schnupperstudium.robots.entity.item.Star 1 8